Amy Winehouse - Rehab
Anthrax - Caught in a Mosh
At the Drive-In - One Armed Scissor
Avenged Sevenfold - Beast and the Harlot
Barenaked Ladies - One Week
Big Country - In a Big Country
Blondie - Heart of Glass
Bob Marley and the Wailers - Get Up, Stand Up
Chicago - 25 or 6 to 4
David Bowie - Space Oddity
Deep Purple - Smoke on the Water
Def Leppard - Foolin'
Devo - Whip It
Dio - Rainbow in the Dark
Dire Straits - Walk of Life
Dover - King George
Echo & The Bunnymen - The Killing Moon
Elton John - Saturday Night's Alright for Fighting
Faith No More - MidLife Crisis
Filter - Hey Man Nice Shot
Foreigner - Cold as Ice
Golden Earring - Radar Love
H.I.M. - Killing Loneliness
Huey Lewis and the News - The Power of Love
Hypernova - Viva la Resistance
Ida Maria - Oh My God
INXS - Need You Tonight
James Brown - I Got You (I Feel Good)
Jane's Addiction - Been Caught Stealing
Joan Jett & The Blackhearts - I Love Rock N' Roll
John Lennon - Imagine
Juanes - Me Enamora
Lazy Town (Robbie Rotten) - We Are Number One
Lemon Demon - Two Trucks
Lynyrd Skynyrd - Free Bird
Man√° - Oye Mi Amor
Marilyn Manson - The Beautiful People
Maroon 5 - Moves Like Jagger
Metric - Combat Baby
Night Ranger - Sister Christian
Ozzy Osbourne - Crazy Train
P!nk - Raise Your Glass
Paramore - Misery Business
Phish - Llama
Phoenix - Lasso
Poni Hoax - Antibodies
Pretty Girls Make Graves - Something Bigger, Something Brighter
Primus - Jerry Was a Race Car Driver
Queen - Bohemian Rhapsody
Queens of the Stone Age - No One Knows
Rammstein - Du Hast
Ramones - I Wanna Be Sedated
Rilo Kiley - Portions for Foxes
Riverboat Gamblers - Don't Bury Me... I'm Still Not Dead
Roxette - The Look
Slipknot - Before I Forget
Smash Mouth - Walking on the Sun
Spacehog - In the Meantime
Steve Miller Band - Fly Like an Eagle
Stone Temple Pilots - Plush
Swingin' Utters - This Bastard's Life
T. Rex - 20th Century Boy
Tears for Fears - Everybody Wants to Rule the World
Tegan and Sara - The Con
The B-52's - Rock Lobster
The Beach Boys - Good Vibrations (Live)
The Bronx - False Alarm
The Cure - Just Like Heaven
The Doobie Brothers - China Grove
The Doors - Break on Through (To the Other Side)
The Flaming Lips - Yoshimi Battles the Pink Robots Pt. 1
The J. Geils Band - Centerfold
The Jimi Hendrix Experience - Crosstown Traffic
The Muffs - Outer Space
The Police - Don't Stand So Close to Me
The Raveonettes - Last Dance
The Smiths - Stop Me if You Think You've Heard This One Before
The Sounds - Living in America
The Vines - Get Free
The White Stripes - The Hardest Button to Button
The Who - I Can See for Miles
Them Crooked Vultures - Dead End Friends
Tokio Hotel - Humanoid
Tom Petty and the Heartbreakers - I Need to Know
WAR - Low Rider
Warren Zevon - Werewolves of London
Whitesnake - Here I Go Again
Yes - Roundabout
